NO ./textures/valid/colorstone.xpm
EA ./textures/valid/greystone.xpm
SO ./textures/valid/eagle.xpm
WE ./textures/valid/wood.xpm

F 50,50,50
C 135,206,235

111111111111111111111111111111111111
100000000000000000000000000000000001
100000000000000000000000000000000001
100000000000000000000000000000000001
100000000000000000000000000000000001
1000000000000000000000000000N0000001
100000000000000000000000000000000001
100000000000000000000000000000000001
100000000000000000000000000000000001
100000000000000000000000000000000001
111111111111111111111111111111111111
