NO textures/north.xpm
SO textures/south.xpm
WE textures/west.xpm
EA textures/east.xpm

F 18,53,25
C 153,204,255

111111111111
1          1
111111111111
1          1
1          1
111111111111
1000000000N1
111111111111
